####################
#     *   \   /   \#
# /*      /   *    #
# \   *       /   /#
#   /      *  /    #
#   *       \      #
#   \              #
####################